,userID,placeID,rating,food_rating,service_rating,total,
1,U1077,135085,2,2,2,6,
2,U1077,135038,2,2,1,5,
3,U1077,132825,2,2,2,6,
4,U1077,135060,1,2,2,5,
5,U1068,135104,1,1,2,4,
6,U1068,132740,0,0,0,0,
7,U1068,132663,1,1,1,3,
8,U1068,132732,0,0,0,0,
9,U1068,132630,1,1,1,3,
10,U1067,132584,2,2,2,6,
11,U1067,132733,1,1,1,3,
12,U1067,132732,1,2,2,5,
13,U1067,132630,1,0,1,2,
14,U1067,135104,0,0,0,0,
15,U1067,132560,1,0,0,1,
16,U1103,132584,1,2,1,4,
17,U1103,132732,0,0,2,2,
18,U1103,132630,1,2,0,3,
19,U1103,132613,2,2,2,6,
20,U1103,132667,1,2,2,5,
21,U1103,135104,1,2,0,3,
22,U1103,132663,1,0,2,3,
23,U1103,132733,2,2,2,6,
24,U1107,132660,2,2,1,5,
25,U1107,132584,2,2,2,6,
26,U1107,132733,2,2,2,6,
27,U1044,135088,2,2,2,6,
28,U1044,132583,1,2,1,4,
29,U1070,132608,2,2,1,5,
30,U1070,132609,1,1,1,3,
31,U1070,132613,1,1,0,2,
32,U1031,132663,0,0,0,0,
33,U1031,132665,0,0,0,0,
34,U1031,132668,0,0,0,0,
35,U1082,132630,1,1,1,3,
36,U1023,132715,0,0,0,0,
37,U1023,132717,0,0,0,0,
38,U1082,132613,0,0,0,0,
39,U1082,132594,0,0,0,0,
40,U1082,132608,0,0,0,0,
41,U1082,132609,0,0,0,0,
42,U1082,132663,0,0,0,0,
43,U1082,132560,0,0,0,0,
44,U1060,132564,2,2,2,6,
45,U1060,132717,2,2,2,6,
46,U1060,132733,2,1,2,5,
47,U1060,132740,1,2,1,4,
48,U1015,135071,0,0,0,0,
49,U1123,132733,1,2,1,4,
50,U1123,132608,1,2,1,4,
51,U1123,135104,2,2,2,6,
52,U1123,132584,1,2,0,3,
53,U1123,132667,1,2,1,4,
54,U1123,132740,1,1,1,3,
55,U1123,132613,1,2,1,4,
56,U1123,132594,1,1,1,3,
57,U1021,132740,2,2,1,5,
58,U1026,132626,2,2,2,6,
59,U1021,132668,2,2,2,6,
60,U1021,132715,2,2,1,5,
61,U1044,134987,0,0,0,0,
62,U1083,135034,2,2,2,6,
63,U1083,132723,1,1,1,3,
64,U1083,135046,2,2,1,5,
65,U1108,135075,2,2,2,6,
66,U1108,132572,1,2,1,4,
67,U1108,135074,2,2,1,5,
68,U1108,135028,1,1,1,3,
69,U1108,135085,1,2,1,4,
70,U1108,135032,2,1,2,5,
71,U1108,135086,1,1,0,2,
72,U1108,132723,2,2,2,6,
73,U1108,135046,1,2,1,4,
74,U1108,135058,1,1,1,3,
75,U1012,135001,1,1,2,4,
76,U1012,134983,2,2,2,6,
77,U1012,134996,2,2,2,6,
78,U1093,135019,2,2,2,6,
79,U1093,134996,2,2,2,6,
80,U1093,135001,2,2,2,6,
81,U1093,134976,2,2,1,5,
82,U1093,134999,2,2,2,6,
83,U1030,135018,2,2,2,6,
84,U1093,135013,2,2,1,5,
85,U1030,134986,2,2,2,6,
86,U1012,134986,2,2,2,6,
87,U1012,135018,2,2,2,6,
88,U1030,135088,1,0,1,2,
89,U1093,132767,2,2,2,6,
90,U1030,135016,0,0,0,0,
91,U1093,135011,1,1,0,2,
92,U1030,132767,0,0,0,0,
93,U1030,135019,0,0,0,0,
94,U1030,135109,0,0,0,0,
95,U1030,134996,0,0,0,0,
96,U1066,135011,1,2,2,5,
97,U1066,134999,1,1,1,3,
98,U1127,134975,2,2,2,6,
99,U1127,135021,2,1,1,4,
100,U1127,134987,2,0,2,4,
101,U1127,134996,2,2,2,6,
102,U1017,132768,1,1,1,3,
103,U1066,135019,2,1,0,3,
104,U1017,134975,2,1,1,4,
105,U1017,134983,0,0,1,1,
106,U1066,132767,1,2,1,4,
107,U1100,135021,2,1,0,3,
108,U1100,134996,2,1,1,4,
109,U1066,135013,1,2,2,5,
110,U1100,135000,2,1,1,4,
111,U1100,135001,2,2,2,6,
112,U1100,132768,2,2,2,6,
113,U1100,134976,2,2,1,5,
114,U1133,134983,1,1,1,3,
115,U1133,134986,2,2,2,6,
116,U1133,132766,1,1,0,2,
117,U1133,132767,0,0,0,0,
118,U1133,135021,2,2,2,6,
119,U1133,135001,2,2,2,6,
120,U1133,134975,1,1,1,3,
121,U1133,134992,1,2,1,4,
122,U1133,135019,1,2,0,3,
123,U1118,134987,0,0,0,0,
124,U1072,135016,1,2,2,5,
125,U1072,132773,2,1,2,5,
126,U1072,135088,0,1,0,1,
127,U1026,132561,1,1,1,3,
128,U1026,132706,0,2,0,2,
129,U1026,132654,0,0,0,0,
130,U1026,132665,2,2,2,6,
131,U1023,132740,0,0,0,0,
132,U1023,132733,2,2,2,6,
133,U1080,132668,1,1,1,3,
134,U1080,132660,2,2,2,6,
135,U1080,132733,1,1,1,3,
136,U1080,132608,2,2,2,6,
137,U1063,132660,2,2,2,6,
138,U1063,132584,2,1,1,4,
139,U1063,132609,1,0,1,2,
140,U1063,135104,1,2,1,4,
141,U1063,132667,1,2,1,4,
142,U1080,132564,1,1,1,3,
143,U1080,132715,1,1,1,3,
144,U1082,132732,0,0,0,0,
145,U1082,132733,0,0,0,0,
146,U1074,135011,2,1,2,5,
147,U1074,134987,2,2,2,6,
148,U1074,134976,2,2,2,6,
149,U1117,135018,1,1,1,3,
150,U1117,132766,0,0,1,1,
151,U1117,135088,1,1,2,4,
152,U1117,135016,2,2,1,5,
153,U1117,132773,1,2,2,5,
154,U1117,135000,1,1,1,3,
155,U1118,132583,0,0,0,0,
156,U1118,132768,0,0,0,0,
157,U1118,135021,2,0,0,2,
158,U1118,134983,0,0,0,0,
159,U1118,135001,0,0,0,0,
160,U1118,134992,0,0,0,0,
161,U1020,135088,1,2,0,3,
162,U1020,132768,2,2,2,6,
163,U1020,134996,1,1,1,3,
164,U1020,135109,2,2,1,5,
165,U1051,135088,1,1,1,3,
166,U1051,135109,1,1,1,3,
167,U1051,132768,1,2,1,4,
168,U1055,135051,1,2,2,5,
169,U1055,135075,2,2,2,6,
170,U1055,132572,2,2,2,6,
171,U1055,135028,2,2,2,6,
172,U1055,135025,2,2,2,6,
173,U1083,132572,2,2,2,6,
174,U1083,135049,0,0,0,0,
175,U1055,135106,2,2,2,6,
176,U1083,135072,1,2,2,5,
177,U1083,135074,2,2,2,6,
178,U1083,132755,2,2,2,6,
179,U1083,135044,1,2,2,5,
180,U1055,135048,2,2,2,6,
181,U1055,135047,2,2,2,6,
182,U1055,132754,2,2,2,6,
183,U1055,132825,2,2,2,6,
184,U1053,135076,1,1,1,3,
185,U1053,135032,2,2,1,5,
186,U1053,132825,1,2,0,3,
187,U1053,135063,2,1,2,5,
188,U1035,135018,1,2,1,4,
189,U1035,132773,2,1,2,5,
190,U1053,135042,2,1,2,5,
191,U1053,135053,2,2,0,4,
192,U1053,132754,1,2,1,4,
193,U1035,132583,1,0,2,3,
194,U1053,135081,2,2,1,5,
195,U1053,135025,2,1,2,5,
196,U1053,135038,2,1,2,5,
197,U1053,135060,2,2,1,5,
198,U1053,135062,2,1,1,4,
199,U1053,135047,2,2,2,6,
200,U1064,135042,1,2,1,4,
201,U1081,135069,1,0,1,2,
202,U1064,135057,1,1,2,4,
203,U1081,135076,1,2,2,5,
204,U1081,135043,0,0,1,1,
205,U1064,135069,0,0,1,1,
206,U1081,135039,0,0,0,0,
207,U1064,135060,1,0,1,2,
208,U1064,135052,2,0,2,4,
209,U1081,132825,1,0,1,2,
210,U1081,135032,0,1,1,2,
211,U1081,135028,1,2,2,5,
212,U1081,135085,1,2,1,4,
213,U1081,135052,0,1,1,2,
214,U1081,135030,1,1,1,3,
215,U1081,135027,0,1,1,2,
216,U1001,132830,1,1,1,3,
217,U1001,132825,2,2,1,5,
218,U1014,135076,1,2,1,4,
219,U1088,132830,0,2,2,4,
220,U1088,135108,2,2,2,6,
221,U1014,135069,1,0,1,2,
222,U1014,135050,2,2,2,6,
223,U1088,135057,1,2,2,5,
224,U1014,135081,2,1,1,4,
225,U1014,135057,1,0,2,3,
226,U1014,135070,2,2,2,6,
227,U1088,135041,2,2,2,6,
228,U1088,135069,1,2,2,5,
229,U1088,135082,2,2,2,6,
230,U1014,135043,1,0,0,1,
231,U1014,135042,1,1,0,2,
232,U1088,135071,0,0,0,0,
233,U1088,135054,2,2,2,6,
234,U1088,135070,2,2,1,5,
235,U1014,135066,2,1,2,5,
236,U1088,135032,2,2,2,6,
237,U1088,135081,1,2,2,5,
238,U1088,135051,2,1,2,5,
239,U1014,132830,2,2,1,5,
240,U1014,135082,0,0,0,0,
241,U1056,135066,2,2,2,6,
242,U1056,135050,0,0,0,0,
243,U1056,135076,2,2,2,6,
244,U1056,135081,2,2,2,6,
245,U1056,135062,2,2,2,6,
246,U1056,135027,2,2,2,6,
247,U1056,135085,2,2,2,6,
248,U1056,135052,2,2,2,6,
249,U1056,132825,2,2,2,6,
250,U1056,135051,2,2,2,6,
251,U1134,135047,1,1,1,3,
252,U1134,135026,0,0,0,0,
253,U1134,135044,1,1,1,3,
254,U1134,132825,1,2,1,4,
255,U1134,135059,2,1,0,3,
256,U1134,135065,2,2,2,6,
257,U1134,135046,2,1,1,4,
258,U1134,135085,2,1,2,5,
259,U1134,135079,1,1,2,4,
260,U1134,135055,2,2,2,6,
261,U1134,132754,2,1,1,4,
262,U1134,132572,0,0,0,0,
263,U1134,135075,2,1,1,4,
264,U1134,135080,1,1,1,3,
265,U1134,135064,2,2,2,6,
266,U1134,135074,2,2,2,6,
267,U1106,135041,1,1,1,3,
268,U1126,135069,0,0,0,0,
269,U1106,135032,0,0,0,0,
270,U1126,135057,2,2,2,6,
271,U1126,132830,0,0,0,0,
272,U1106,135028,2,1,0,3,
273,U1126,135040,0,0,0,0,
274,U1126,135106,2,2,2,6,
275,U1126,135052,2,1,1,4,
276,U1126,135041,2,1,1,4,
277,U1126,135038,1,0,1,2,
278,U1126,135054,1,2,1,4,
279,U1126,135108,2,2,1,5,
280,U1044,134986,2,2,2,6,
281,U1124,135054,1,1,1,3,
282,U1044,132768,2,2,2,6,
283,U1124,135108,1,1,1,3,
284,U1124,135032,1,1,1,3,
285,U1124,135071,1,0,1,2,
286,U1124,135070,1,1,1,3,
287,U1124,135069,1,1,1,3,
288,U1124,135081,1,1,0,2,
289,U1124,135057,1,1,1,3,
290,U1124,135039,1,1,1,3,
291,U1124,135050,0,1,0,1,
292,U1018,135043,0,0,0,0,
293,U1125,135043,1,1,2,4,
294,U1125,135081,0,0,2,2,
295,U1125,135076,1,1,1,3,
296,U1018,135082,2,2,2,6,
297,U1125,135050,2,1,1,4,
298,U1125,135066,1,0,1,2,
299,U1125,135032,1,2,1,4,
300,U1119,134986,2,2,2,6,
301,U1119,135021,0,0,0,0,
302,U1119,135001,2,2,2,6,
303,U1125,135042,1,1,1,3,
304,U1119,132583,2,2,2,6,
305,U1125,135063,1,2,1,4,
306,U1119,132768,2,2,2,6,
307,U1125,135060,1,0,2,3,
308,U1125,135038,2,2,1,5,
309,U1125,135062,1,2,1,4,
310,U1018,135081,1,1,1,3,
311,U1018,135057,1,1,0,2,
312,U1018,135066,1,1,1,3,
313,U1018,135032,1,1,1,3,
314,U1018,135062,0,0,1,1,
315,U1018,135025,1,1,1,3,
316,U1018,135069,0,1,1,2,
317,U1018,135108,1,0,1,2,
318,U1076,135039,2,2,1,5,
319,U1076,135038,1,2,2,5,
320,U1076,135027,0,1,1,2,
321,U1076,135042,2,2,2,6,
322,U1022,135040,0,0,0,0,
323,U1076,135073,2,1,1,4,
324,U1022,135033,1,1,2,4,
325,U1022,135025,0,0,0,0,
326,U1022,135032,1,1,2,4,
327,U1022,135057,2,2,2,6,
328,U1022,135060,1,1,2,4,
329,U1022,135052,2,2,2,6,
330,U1022,135038,2,1,2,5,
331,U1022,135081,0,2,1,3,
332,U1022,135045,2,1,1,4,
333,U1022,135051,2,1,1,4,
334,U1022,135073,2,2,2,6,
335,U1022,135062,1,2,1,4,
336,U1022,135063,2,1,2,5,
337,U1094,135054,0,0,0,0,
338,U1094,135082,0,0,0,0,
339,U1094,135057,0,1,0,1,
340,U1094,135071,0,1,0,1,
341,U1094,132830,0,1,0,1,
342,U1094,135070,0,1,0,1,
343,U1094,135108,0,1,1,2,
344,U1094,135069,0,1,0,1,
345,U1116,135047,2,2,2,6,
346,U1116,135060,0,0,0,0,
347,U1116,135038,2,2,2,6,
348,U1116,135085,2,2,2,6,
349,U1116,135052,2,2,2,6,
350,U1116,135025,2,2,2,6,
351,U1116,135059,0,2,2,4,
352,U1116,135027,0,2,2,4,
353,U1116,132825,2,2,2,6,
354,U1116,135030,1,2,2,5,
355,U1116,132834,2,2,2,6,
356,U1105,135057,0,0,0,0,
357,U1105,135069,0,0,0,0,
358,U1105,132830,0,0,0,0,
359,U1105,135040,0,0,0,0,
360,U1105,135033,0,0,0,0,
361,U1105,135054,0,0,0,0,
362,U1105,135039,0,0,0,0,
363,U1105,135052,0,0,0,0,
364,U1075,135081,1,2,1,4,
365,U1075,135066,2,1,2,5,
366,U1075,135050,2,2,2,6,
367,U1007,135108,1,1,1,3,
368,U1075,135076,2,2,0,4,
369,U1007,135057,1,1,2,4,
370,U1075,135032,1,1,1,3,
371,U1075,132834,1,2,1,4,
372,U1075,135057,2,1,1,4,
373,U1075,132830,1,1,1,3,
374,U1075,135062,1,0,1,2,
375,U1075,135039,2,2,0,4,
376,U1075,135051,1,1,1,3,
377,U1075,135041,1,1,0,2,
378,U1115,135057,2,2,2,6,
379,U1115,135082,2,2,2,6,
380,U1115,135054,0,0,1,1,
381,U1115,135108,1,2,2,5,
382,U1115,135069,1,0,1,2,
383,U1115,132830,2,2,2,6,
384,U1115,135070,1,1,1,3,
385,U1115,135071,2,2,2,6,
386,U1072,135000,0,0,0,0,
387,U1024,132834,1,1,1,3,
388,U1024,135106,1,1,1,3,
389,U1024,135042,1,2,1,4,
390,U1024,132825,1,1,0,2,
391,U1024,135060,1,0,2,3,
392,U1024,135032,2,2,2,6,
393,U1024,135039,2,2,2,6,
394,U1024,135045,2,2,0,4,
395,U1024,135027,1,2,0,3,
396,U1024,135073,1,2,0,3,
397,U1024,135051,1,1,0,2,
398,U1024,135041,1,1,1,3,
399,U1024,135038,1,1,0,2,
400,U1024,135028,1,1,1,3,
401,U1024,135030,1,1,1,3,
402,U1132,135038,1,1,1,3,
403,U1132,132825,2,2,2,6,
404,U1132,135085,2,2,2,6,
405,U1132,135062,2,1,1,4,
406,U1132,135025,1,1,2,4,
407,U1132,135052,2,2,2,6,
408,U1132,135028,2,2,2,6,
409,U1132,135032,1,0,1,2,
410,U1132,135051,1,1,0,2,
411,U1132,135027,2,1,0,3,
412,U1005,135050,1,2,1,4,
413,U1005,135076,2,2,1,5,
414,U1005,132830,1,1,0,2,
415,U1005,135066,2,1,1,4,
416,U1005,135041,1,1,1,3,
417,U1005,135057,1,2,1,4,
418,U1005,135043,0,2,0,2,
419,U1005,135042,2,1,2,5,
420,U1005,135032,2,1,2,5,
421,U1120,135085,0,0,0,0,
422,U1120,132845,1,0,2,3,
423,U1120,135032,1,1,1,3,
424,U1120,135045,1,2,2,5,
425,U1120,135038,0,0,0,0,
426,U1004,135060,1,1,1,3,
427,U1004,135028,2,2,2,6,
428,U1004,135106,2,2,2,6,
429,U1120,135057,2,2,2,6,
430,U1004,135062,2,2,1,5,
431,U1120,135026,1,1,1,3,
432,U1004,135032,2,2,2,6,
433,U1120,132846,2,2,1,5,
434,U1077,135027,0,1,1,2,
435,U1120,132847,2,2,2,6,
436,U1037,135054,2,1,1,4,
437,U1037,135082,0,0,0,0,
438,U1037,135070,0,0,0,0,
439,U1037,132845,0,0,0,0,
440,U1037,135108,2,2,2,6,
441,U1037,132847,1,1,1,3,
442,U1037,132830,2,2,2,6,
443,U1035,135000,2,2,2,6,
444,U1035,134996,2,1,2,5,
445,U1035,134986,2,2,2,6,
446,U1052,132851,1,0,2,3,
447,U1036,132834,1,2,2,5,
448,U1036,135064,2,2,1,5,
449,U1036,135079,2,2,2,6,
450,U1036,135042,2,2,2,6,
451,U1036,135085,2,2,2,6,
452,U1036,135025,2,2,2,6,
453,U1036,132825,2,2,2,6,
454,U1036,135059,2,2,2,6,
455,U1036,135052,2,2,2,6,
456,U1036,132754,2,2,2,6,
457,U1036,135065,0,0,0,0,
458,U1036,135045,2,2,2,6,
459,U1038,132854,1,2,2,5,
460,U1038,132856,0,1,1,2,
461,U1038,132858,0,2,1,3,
462,U1038,132861,1,1,2,4,
463,U1038,132862,2,2,2,6,
464,U1071,132862,2,2,2,6,
465,U1071,135063,2,1,2,5,
466,U1071,135052,2,2,2,6,
467,U1071,135060,1,2,2,5,
468,U1071,135042,2,2,2,6,
469,U1071,132825,2,2,2,6,
470,U1071,132856,2,2,2,6,
471,U1071,135032,2,2,2,6,
472,U1071,132834,1,1,1,3,
473,U1071,135039,2,2,2,6,
474,U1071,135028,2,2,2,6,
475,U1071,135025,2,2,2,6,
476,U1071,135030,2,2,2,6,
477,U1114,135053,0,0,0,0,
478,U1084,135058,1,0,2,3,
479,U1084,132862,2,2,2,6,
480,U1084,135072,2,2,2,6,
481,U1084,135030,2,2,2,6,
482,U1084,135026,2,2,2,6,
483,U1084,135035,2,2,2,6,
484,U1084,135045,2,2,2,6,
485,U1084,132861,2,2,2,6,
486,U1084,135085,2,2,2,6,
487,U1084,132723,1,0,1,2,
488,U1049,132825,0,0,0,0,
489,U1049,135041,0,0,0,0,
490,U1019,132830,0,0,0,0,
491,U1019,135076,0,0,0,0,
492,U1019,135038,0,0,0,0,
493,U1019,132856,0,0,0,0,
494,U1069,135070,0,0,0,0,
495,U1069,135082,0,0,0,0,
496,U1069,135108,0,0,0,0,
497,U1069,132858,0,0,0,0,
498,U1069,135069,0,0,0,0,
499,U1069,132846,0,0,0,0,
500,U1069,132845,0,0,0,0,
501,U1069,132851,1,0,0,1,
502,U1069,132847,0,2,0,2,
503,U1113,135038,1,2,0,3,
504,U1113,135057,2,2,1,5,
505,U1113,135085,1,2,1,4,
506,U1113,135032,0,0,0,0,
507,U1113,135079,1,2,1,4,
508,U1113,135046,2,2,1,5,
509,U1113,132856,0,1,0,1,
510,U1113,132854,0,0,0,0,
511,U1104,135039,0,0,1,1,
512,U1104,132825,1,2,1,4,
513,U1104,135085,2,2,1,5,
514,U1104,135030,2,1,1,4,
515,U1104,135062,1,1,2,4,
516,U1106,135047,0,0,0,0,
517,U1106,135052,0,0,0,0,
518,U1104,132834,1,2,1,4,
519,U1106,135106,0,0,0,0,
520,U1106,132754,2,2,1,5,
521,U1104,135052,1,1,1,3,
522,U1106,132856,0,1,0,1,
523,U1104,135032,2,1,1,4,
524,U1104,135025,2,1,1,4,
525,U1106,132834,2,1,1,4,
526,U1104,135047,1,2,1,4,
527,U1106,135042,2,0,0,2,
528,U1106,135039,2,1,1,4,
529,U1052,132866,2,2,1,5,
530,U1106,135066,2,1,2,5,
531,U1106,135085,2,2,2,6,
532,U1104,135033,1,1,2,4,
533,U1106,135062,2,2,1,5,
534,U1106,132862,2,2,2,6,
535,U1106,135030,2,2,1,5,
536,U1106,135079,2,2,2,6,
537,U1106,135064,2,2,2,6,
538,U1052,132869,2,2,1,5,
539,U1052,132870,1,1,1,3,
540,U1104,135041,1,2,1,4,
541,U1079,134986,2,2,2,6,
542,U1079,134976,1,1,0,2,
543,U1079,132768,2,2,2,6,
544,U1079,132766,1,2,1,4,
545,U1045,132825,2,1,1,4,
546,U1045,135064,0,0,0,0,
547,U1045,132856,1,2,2,5,
548,U1045,135085,2,2,2,6,
549,U1045,135032,0,0,0,0,
550,U1045,132834,1,1,1,3,
551,U1045,135052,1,2,2,5,
552,U1045,135060,2,2,2,6,
553,U1045,135051,2,2,2,6,
554,U1045,135041,1,2,1,4,
555,U1009,132754,1,2,1,4,
556,U1009,132862,2,1,2,5,
557,U1009,135060,1,1,1,3,
558,U1009,135059,2,1,1,4,
559,U1009,132834,2,2,1,5,
560,U1009,135058,1,1,2,4,
561,U1009,135038,2,2,2,6,
562,U1009,132825,1,1,0,2,
563,U1009,135052,2,1,0,3,
564,U1009,135063,0,0,0,0,
565,U1009,135079,1,2,2,5,
566,U1016,132834,2,2,2,6,
567,U1016,135042,1,2,2,5,
568,U1016,135032,2,2,2,6,
569,U1016,135106,2,2,2,6,
570,U1016,132856,2,2,2,6,
571,U1016,135045,2,2,2,6,
572,U1016,135060,2,2,2,6,
573,U1016,135066,2,2,2,6,
574,U1016,135085,2,2,0,4,
575,U1016,135052,2,2,2,6,
576,U1016,132862,2,2,2,6,
577,U1016,135051,2,2,0,4,
578,U1016,135062,2,2,2,6,
579,U1047,132875,0,0,0,0,
580,U1047,132877,0,0,0,0,
581,U1047,132884,0,0,0,0,
582,U1095,132872,1,2,2,5,
583,U1095,135034,2,2,2,6,
584,U1095,135058,1,2,2,5,
585,U1034,135086,1,1,1,3,
586,U1095,132861,1,1,1,3,
587,U1034,135049,0,0,0,0,
588,U1034,132723,1,0,1,2,
589,U1095,132723,2,2,2,6,
590,U1095,135086,1,2,1,4,
591,U1095,135055,2,2,2,6,
592,U1007,135058,1,2,1,4,
593,U1007,135085,1,2,0,3,
594,U1095,135064,1,1,1,3,
595,U1095,135035,2,2,2,6,
596,U1095,135072,2,2,2,6,
597,U1007,135025,1,1,1,3,
598,U1007,135032,1,1,0,2,
599,U1007,135086,0,0,0,0,
600,U1007,132572,1,1,1,3,
601,U1007,135038,1,1,0,2,
602,U1078,132885,1,1,1,3,
603,U1099,135076,1,1,0,2,
604,U1099,132834,2,2,2,6,
605,U1008,132866,1,1,1,3,
606,U1008,132858,1,2,1,4,
607,U1099,135043,2,2,2,6,
608,U1099,132885,0,0,0,0,
609,U1008,132854,2,2,1,5,
610,U1099,132872,1,1,2,4,
611,U1008,135108,1,1,0,2,
612,U1008,132851,1,1,1,3,
613,U1099,132856,1,1,0,2,
614,U1008,132869,1,1,1,3,
615,U1099,135066,1,1,1,3,
616,U1008,135069,1,1,1,3,
617,U1099,135038,0,1,1,2,
618,U1099,135060,2,2,2,6,
619,U1099,135045,1,1,1,3,
620,U1008,132846,1,1,1,3,
621,U1008,135054,1,1,1,3,
622,U1099,135042,1,1,1,3,
623,U1040,132773,1,1,1,3,
624,U1040,134999,1,1,1,3,
625,U1040,135013,2,2,2,6,
626,U1040,135019,1,2,1,4,
627,U1121,135021,0,0,0,0,
628,U1110,135021,1,2,1,4,
629,U1110,132767,2,2,2,6,
630,U1110,135013,2,2,2,6,
631,U1110,134999,2,2,2,6,
632,U1121,135019,2,2,2,6,
633,U1121,132767,2,2,2,6,
634,U1121,134999,2,2,2,6,
635,U1042,132768,2,2,1,5,
636,U1042,135021,1,2,0,3,
637,U1042,134996,2,2,2,6,
638,U1013,135079,1,1,1,3,
639,U1013,135072,2,1,1,4,
640,U1013,135085,1,2,0,3,
641,U1013,135076,1,1,0,2,
642,U1054,135062,2,2,0,4,
643,U1054,135060,2,2,2,6,
644,U1054,135039,2,2,1,5,
645,U1054,135052,2,2,1,5,
646,U1054,132856,2,2,2,6,
647,U1054,135051,2,2,0,4,
648,U1054,135025,2,2,2,6,
649,U1054,135041,2,2,2,6,
650,U1054,135038,2,1,1,4,
651,U1054,135032,1,1,1,3,
652,U1054,135045,2,1,2,5,
653,U1042,134986,2,2,2,6,
654,U1042,134992,1,2,1,4,
655,U1111,132845,2,2,1,5,
656,U1111,135071,2,2,2,6,
657,U1111,132858,1,1,1,3,
658,U1111,132854,2,2,2,6,
659,U1111,132877,1,1,1,3,
660,U1037,135071,1,0,0,1,
661,U1111,132851,2,1,0,3,
662,U1111,135108,2,1,0,3,
663,U1111,132869,0,0,0,0,
664,U1037,132869,1,1,2,4,
665,U1111,132870,0,0,0,0,
666,U1037,132851,2,2,1,5,
667,U1111,132847,0,0,0,0,
668,U1111,135082,1,0,0,1,
669,U1037,132854,1,2,0,3,
670,U1015,132845,1,1,1,3,
671,U1015,132866,0,1,1,2,
672,U1015,132870,0,0,1,1,
673,U1015,135054,1,1,1,3,
674,U1015,132869,2,2,2,6,
675,U1015,132851,1,1,1,3,
676,U1015,132877,1,1,2,4,
677,U1128,132872,0,0,0,0,
678,U1062,132872,0,0,0,0,
679,U1101,135039,1,1,1,3,
680,U1101,135027,2,1,1,4,
681,U1101,135073,1,1,1,3,
682,U1101,135106,0,0,0,0,
683,U1101,132856,1,0,1,2,
684,U1101,135032,2,2,1,5,
685,U1101,135038,2,2,1,5,
686,U1101,135051,2,0,2,4,
687,U1101,135052,2,1,1,4,
688,U1101,135041,0,0,0,0,
689,U1001,135085,0,1,1,2,
690,U1001,135040,1,1,1,3,
691,U1001,135039,1,1,1,3,
692,U1001,135045,1,1,1,3,
693,U1001,135033,1,1,1,3,
694,U1001,135025,2,2,2,6,
695,U1001,135051,1,1,2,4,
696,U1135,135085,0,0,0,0,
697,U1135,135106,0,0,0,0,
698,U1135,135052,0,0,0,0,
699,U1135,135041,0,0,0,0,
700,U1032,132872,1,1,1,3,
701,U1032,135058,2,1,0,3,
702,U1032,135079,2,2,0,4,
703,U1032,135085,1,1,1,3,
704,U1032,135042,0,1,0,1,
705,U1032,132856,1,1,0,2,
706,U1135,132825,0,0,0,0,
707,U1135,132834,0,0,0,0,
708,U1032,135038,1,1,0,2,
709,U1032,132834,1,1,0,2,
710,U1032,135060,1,1,1,3,
711,U1135,135058,0,0,0,0,
712,U1032,135032,0,0,0,0,
713,U1135,135063,0,0,0,0,
714,U1135,132856,0,0,0,0,
715,U1135,135045,0,0,0,0,
716,U1135,135028,0,0,0,0,
717,U1135,135032,0,0,0,0,
718,U1135,135042,0,0,0,0,
719,U1135,135060,0,0,0,0,
720,U1048,135049,1,0,2,3,
721,U1048,135026,2,2,2,6,
722,U1048,135034,2,2,1,5,
723,U1048,135048,0,1,0,1,
724,U1048,135065,2,2,0,4,
725,U1048,132755,2,2,2,6,
726,U1048,132723,2,2,2,6,
727,U1062,135085,0,0,0,0,
728,U1062,135053,0,0,0,0,
729,U1092,135071,1,0,0,1,
730,U1062,132825,0,0,0,0,
731,U1092,135085,0,0,0,0,
732,U1062,135052,0,0,0,0,
733,U1092,135046,0,0,0,0,
734,U1062,135062,0,0,0,0,
735,U1092,132572,1,0,0,1,
736,U1062,135038,0,0,0,0,
737,U1062,135045,0,0,0,0,
738,U1092,135025,2,1,1,4,
739,U1062,132834,0,0,0,0,
740,U1092,132723,1,1,1,3,
741,U1051,134996,1,1,2,4,
742,U1013,132875,2,2,1,5,
743,U1085,135043,2,2,2,6,
744,U1085,132885,0,0,0,0,
745,U1085,135050,2,2,2,6,
746,U1085,135076,2,2,2,6,
747,U1085,135081,2,2,2,6,
748,U1109,135028,2,2,2,6,
749,U1109,132856,1,1,1,3,
750,U1085,135042,0,0,0,0,
751,U1085,135059,2,2,1,5,
752,U1109,132825,2,2,2,6,
753,U1085,132872,0,2,2,4,
754,U1085,135055,2,2,2,6,
755,U1109,135032,2,2,2,6,
756,U1085,132825,2,2,2,6,
757,U1109,135063,2,2,2,6,
758,U1109,135042,2,2,2,6,
759,U1109,135058,2,2,2,6,
760,U1109,135085,2,2,2,6,
761,U1109,135038,2,2,2,6,
762,U1109,132872,1,1,1,3,
763,U1078,135081,1,1,1,3,
764,U1078,135060,2,2,2,6,
765,U1078,135106,2,2,2,6,
766,U1078,135041,2,1,2,5,
767,U1078,132834,0,2,1,3,
768,U1078,135052,2,2,2,6,
769,U1019,135079,0,0,0,0,
770,U1102,132846,2,2,2,6,
771,U1098,132885,1,1,0,2,
772,U1098,135060,2,1,2,5,
773,U1098,132856,1,2,1,4,
774,U1046,135026,1,0,2,3,
775,U1122,135066,2,1,1,4,
776,U1122,135065,2,2,2,6,
777,U1122,132872,2,2,2,6,
778,U1122,135058,2,0,2,4,
779,U1122,132834,2,1,1,4,
780,U1122,132754,2,1,2,5,
781,U1122,135079,2,2,2,6,
782,U1122,135038,2,2,2,6,
783,U1122,135085,2,2,1,5,
784,U1122,135030,2,1,1,4,
785,U1122,135064,1,1,1,3,
786,U1122,135053,2,2,2,6,
787,U1138,132921,2,2,1,5,
788,U1138,132922,2,2,2,6,
789,U1138,132925,1,2,1,4,
790,U1013,132921,2,2,1,5,
791,U1098,135085,1,2,1,4,
792,U1098,132825,1,1,1,3,
793,U1098,135079,2,1,1,4,
794,U1098,135032,2,1,1,4,
795,U1098,135038,1,1,1,3,
796,U1098,132861,2,2,1,5,
797,U1098,135046,1,2,1,4,
798,U1098,132862,1,2,2,5,
799,U1098,132921,1,2,1,4,
800,U1034,132884,0,0,0,0,
801,U1034,135055,0,0,0,0,
802,U1034,135035,1,1,1,3,
803,U1033,135065,1,1,1,3,
804,U1033,135028,2,1,1,4,
805,U1033,135085,2,2,2,6,
806,U1033,135046,2,1,1,4,
807,U1033,135045,2,1,2,5,
808,U1033,132951,2,1,0,3,
809,U1033,132572,1,0,0,1,
810,U1033,132921,2,1,1,4,
811,U1033,135075,2,1,0,3,
812,U1033,135038,1,1,1,3,
813,U1033,135030,2,1,1,4,
814,U1089,135058,1,1,1,3,
815,U1089,135064,1,1,1,3,
816,U1089,135028,1,1,1,3,
817,U1089,132951,1,1,1,3,
818,U1003,135064,0,0,0,0,
819,U1089,132921,1,1,1,3,
820,U1003,132825,2,2,1,5,
821,U1089,132754,1,1,1,3,
822,U1003,135075,2,2,2,6,
823,U1089,135026,1,1,1,3,
824,U1003,132862,1,2,2,5,
825,U1089,132872,1,1,1,3,
826,U1089,135085,1,1,1,3,
827,U1003,135041,0,1,1,2,
828,U1089,135072,1,1,1,3,
829,U1089,132834,1,1,1,3,
830,U1003,132937,2,2,1,5,
831,U1089,132875,1,1,1,3,
832,U1089,135038,0,0,0,0,
833,U1003,132922,2,2,2,6,
834,U1091,132825,0,1,1,2,
835,U1091,135075,2,2,2,6,
836,U1089,135079,0,0,0,0,
837,U1003,132723,2,2,1,5,
838,U1091,132861,1,1,1,3,
839,U1003,132755,2,2,1,5,
840,U1091,132875,1,2,2,5,
841,U1003,135080,2,1,2,5,
842,U1091,135086,1,1,1,3,
843,U1003,135079,2,2,2,6,
844,U1027,135066,0,0,0,0,
845,U1091,135080,0,1,1,2,
846,U1027,132921,1,1,1,3,
847,U1091,132572,2,2,2,6,
848,U1027,135052,1,1,1,3,
849,U1091,132884,2,2,2,6,
850,U1091,135035,1,1,1,3,
851,U1027,132937,1,1,1,3,
852,U1027,132951,1,1,1,3,
853,U1027,132925,1,1,1,3,
854,U1027,132872,1,1,1,3,
855,U1027,132875,1,1,1,3,
856,U1027,135085,1,1,1,3,
857,U1027,135042,1,1,1,3,
858,U1027,135062,1,1,1,3,
859,U1029,135047,1,1,1,3,
860,U1029,135059,2,1,1,4,
861,U1029,132937,1,1,1,3,
862,U1029,135085,1,1,1,3,
863,U1029,132834,0,1,0,1,
864,U1029,132754,0,0,0,0,
865,U1029,132825,1,1,0,2,
866,U1029,132921,1,1,1,3,
867,U1029,132862,1,1,1,3,
868,U1029,132922,1,1,1,3,
869,U1086,135063,1,1,1,3,
870,U1086,132921,1,1,1,3,
871,U1086,135085,2,1,1,4,
872,U1086,132922,2,1,2,5,
873,U1086,132937,2,0,1,3,
874,U1086,135045,2,2,2,6,
875,U1086,135041,2,2,2,6,
876,U1086,135060,1,1,1,3,
877,U1086,132951,1,1,1,3,
878,U1019,132921,0,0,0,0,
879,U1019,132834,0,0,0,0,
880,U1137,132951,2,2,2,6,
881,U1019,135062,0,0,0,0,
882,U1019,135086,0,0,0,0,
883,U1137,135085,2,1,2,5,
884,U1137,132834,2,2,2,6,
885,U1090,132572,1,1,2,4,
886,U1137,132862,2,2,2,6,
887,U1137,135058,0,2,2,4,
888,U1137,135059,2,0,2,4,
889,U1137,135062,2,2,2,6,
890,U1137,132825,2,2,1,5,
891,U1137,132723,2,2,2,6,
892,U1137,132755,2,2,2,6,
893,U1137,135042,2,2,2,6,
894,U1137,132884,2,2,2,6,
895,U1137,135049,2,2,2,6,
896,U1137,135075,2,2,2,6,
897,U1114,132825,0,0,0,0,
898,U1114,135065,0,0,0,0,
899,U1114,135058,0,0,0,0,
900,U1114,132723,0,0,0,0,
901,U1114,132951,0,0,0,0,
902,U1114,132872,1,1,1,3,
903,U1114,132834,0,0,0,0,
904,U1114,135072,0,0,0,0,
905,U1114,132754,0,0,0,0,
906,U1114,132755,1,2,1,4,
907,U1061,132825,1,2,1,4,
908,U1061,135048,2,2,2,6,
909,U1061,132921,1,2,1,4,
910,U1061,135026,2,2,2,6,
911,U1061,132723,2,2,1,5,
912,U1061,135075,2,2,2,6,
913,U1061,135034,2,2,2,6,
914,U1061,135041,2,2,2,6,
915,U1013,132572,1,1,0,2,
916,U1013,135075,2,2,1,5,
917,U1061,135046,1,2,1,4,
918,U1061,132572,1,2,2,5,
919,U1061,135058,1,1,1,3,
920,U1046,135044,1,1,0,2,
921,U1046,135065,2,2,2,6,
922,U1046,132921,2,1,2,5,
923,U1046,135085,1,2,1,4,
924,U1046,132572,1,2,0,3,
925,U1046,135058,2,2,1,5,
926,U1046,132951,1,1,2,4,
927,U1046,132861,1,2,2,5,
928,U1041,135001,1,1,1,3,
929,U1041,134983,2,2,2,6,
930,U1041,135021,2,2,2,6,
931,U1041,134992,2,2,2,6,
932,U1041,132768,2,2,1,5,
933,U1041,135109,1,2,1,4,
934,U1004,132954,2,2,2,6,
935,U1004,132955,2,2,2,6,
936,U1004,132958,2,2,2,6,
937,U1003,132754,2,2,2,6,
938,U1059,135064,1,1,0,2,
939,U1059,135075,2,2,1,5,
940,U1059,135028,1,1,1,3,
941,U1061,132834,1,2,1,4,
942,U1061,135086,1,1,2,4,
943,U1061,132754,2,2,2,6,
944,U1061,135080,2,2,2,6,
945,U1090,135062,2,2,2,6,
946,U1090,135052,2,2,2,6,
947,U1112,135047,0,0,0,0,
948,U1112,135026,1,1,1,3,
949,U1112,135064,0,1,1,2,
950,U1090,132862,2,2,2,6,
951,U1057,135070,1,1,1,3,
952,U1112,132954,0,0,1,1,
953,U1057,135043,1,1,1,3,
954,U1112,135079,1,0,0,1,
955,U1112,135062,0,0,1,1,
956,U1090,135051,1,2,1,4,
957,U1090,132954,2,2,2,6,
958,U1112,135048,0,0,0,0,
959,U1057,132954,1,0,0,1,
960,U1112,135086,0,0,0,0,
961,U1061,132955,2,2,2,6,
962,U1112,132921,1,0,0,1,
963,U1061,132958,2,2,2,6,
964,U1112,135046,0,0,0,0,
965,U1090,135085,2,2,2,6,
966,U1112,132572,0,0,1,1,
967,U1090,132922,2,2,2,6,
968,U1025,132866,2,1,2,5,
969,U1057,135080,1,1,0,2,
970,U1112,132834,1,0,0,1,
971,U1057,132825,1,1,0,2,
972,U1112,132862,1,1,1,3,
973,U1061,132954,2,1,2,5,
974,U1025,132877,1,1,1,3,
975,U1057,135064,1,1,0,2,
976,U1057,135046,1,0,0,1,
977,U1090,135025,2,2,2,6,
978,U1090,132925,2,2,2,6,
979,U1057,132862,1,0,0,1,
980,U1057,135075,0,1,1,2,
981,U1025,132847,2,1,1,4,
982,U1057,135030,1,0,1,2,
983,U1025,135071,2,2,2,6,
984,U1057,132834,1,0,1,2,
985,U1025,132958,1,0,0,1,
986,U1025,132825,0,0,0,0,
987,U1025,135028,2,1,0,3,
988,U1025,135047,1,1,1,3,
989,U1025,132846,2,2,2,6,
990,U1025,135064,2,2,2,6,
991,U1025,132830,2,2,2,6,
992,U1097,135079,2,1,0,3,
993,U1097,135058,2,1,1,4,
994,U1097,132954,1,1,0,2,
995,U1097,132958,2,1,1,4,
996,U1097,135026,1,0,1,2,
997,U1059,132955,2,1,2,5,
998,U1059,135044,2,1,1,4,
999,U1059,132862,0,0,0,0,
1000,U1059,135085,2,2,2,6,
1001,U1059,135030,2,2,2,6,
1002,U1128,135053,0,0,0,0,
1003,U1059,132825,2,1,1,4,
1004,U1059,132754,2,2,2,6,
1005,U1128,135058,0,0,0,0,
1006,U1128,132875,0,0,0,0,
1007,U1128,135079,0,0,0,0,
1008,U1128,132925,0,0,0,0,
1009,U1128,135064,0,0,0,0,
1010,U1128,132921,0,0,0,0,
1011,U1128,135060,0,0,0,0,
1012,U1128,132954,0,0,0,0,
1013,U1128,132951,0,0,0,0,
1014,U1097,132921,2,2,1,5,
1015,U1097,132955,2,2,1,5,
1016,U1097,132884,1,1,1,3,
1017,U1097,135049,2,1,1,4,
1018,U1097,135034,2,2,1,5,
1019,U1006,132954,1,1,1,3,
1020,U1006,135079,1,1,1,3,
1021,U1006,132875,2,2,2,6,
1022,U1006,135026,2,2,2,6,
1023,U1006,132922,2,1,2,5,
1024,U1006,132572,1,0,1,2,
1025,U1006,135075,1,1,2,4,
1026,U1006,132825,1,1,1,3,
1027,U1006,135048,1,1,2,4,
1028,U1006,135030,1,1,2,4,
1029,U1006,132884,2,2,2,6,
1030,U1131,135054,2,1,2,5,
1031,U1131,132869,1,2,1,4,
1032,U1131,132866,2,2,2,6,
1033,U1131,135082,0,1,0,1,
1034,U1131,132851,2,2,2,6,
1035,U1131,132870,0,2,0,2,
1036,U1073,135062,0,0,0,0,
1037,U1073,132572,0,0,0,0,
1038,U1073,135064,0,0,0,0,
1039,U1073,135080,0,0,0,0,
1040,U1073,132951,0,0,0,0,
1041,U1073,132954,0,0,0,0,
1042,U1073,135052,0,0,0,0,
1043,U1073,132834,0,0,0,0,
1044,U1073,135060,0,0,0,0,
1045,U1073,135065,0,0,0,0,
1046,U1073,132862,0,0,0,0,
1047,U1049,132921,0,0,0,0,
1048,U1049,135042,0,0,0,0,
1049,U1049,135032,0,0,0,0,
1050,U1049,135051,0,0,0,0,
1051,U1049,135085,0,0,0,0,
1052,U1049,132862,0,0,0,0,
1053,U1049,135052,0,0,0,0,
1054,U1058,135076,2,2,2,6,
1055,U1058,135043,1,2,2,5,
1056,U1058,135058,2,2,0,4,
1057,U1058,135053,2,1,1,4,
1058,U1058,132885,1,1,1,3,
1059,U1058,135050,1,0,0,1,
1060,U1058,132872,2,2,1,5,
1061,U1058,135066,1,1,1,3,
1062,U1002,132921,2,1,1,4,
1063,U1002,135062,1,2,1,4,
1064,U1002,135106,1,1,1,3,
1065,U1002,132825,2,2,0,4,
1066,U1002,135052,1,1,1,3,
1067,U1002,132862,2,2,2,6,
1068,U1096,132875,2,2,2,6,
1069,U1002,135059,1,2,1,4,
1070,U1002,135041,2,1,0,3,
1071,U1002,132925,1,1,2,4,
1072,U1002,135085,1,1,1,3,
1073,U1096,135025,2,2,2,6,
1074,U1096,135072,1,2,1,4,
1075,U1096,135064,1,1,0,2,
1076,U1096,135086,1,0,2,3,
1077,U1096,135055,2,2,2,6,
1078,U1136,135074,1,1,2,4,
1079,U1096,135026,2,2,2,6,
1080,U1136,132862,2,2,2,6,
1081,U1096,132955,2,2,2,6,
1082,U1136,132921,2,2,2,6,
1083,U1136,135072,1,1,1,3,
1084,U1096,132723,1,2,1,4,
1085,U1136,135055,2,2,2,6,
1086,U1136,135064,1,1,1,3,
1087,U1096,132958,1,2,2,5,
1088,U1096,135075,1,2,1,4,
1089,U1136,132958,2,2,2,6,
1090,U1136,135048,1,2,2,5,
1091,U1136,135046,2,2,2,6,
1092,U1136,135028,2,2,2,6,
1093,U1097,135086,2,0,1,3,
1094,U1097,135053,2,2,2,6,
1095,U1097,132861,2,2,1,5,
1096,U1058,135062,2,2,2,6,
1097,U1058,135055,2,2,2,6,
1098,U1010,135053,1,1,1,3,
1099,U1010,135058,1,0,0,1,
1100,U1010,135079,0,0,0,0,
1101,U1003,135059,2,2,2,6,
1102,U1010,135064,0,2,0,2,
1103,U1010,135047,1,1,1,3,
1104,U1010,135065,1,1,1,3,
1105,U1102,132854,2,2,2,6,
1106,U1102,132858,2,2,0,4,
1107,U1010,135042,2,2,2,6,
1108,U1102,132870,2,2,0,4,
1109,U1010,135076,1,2,2,5,
1110,U1102,132847,2,2,0,4,
1111,U1013,132951,2,2,2,6,
1112,U1013,135060,1,1,0,2,
1113,U1028,132732,1,1,1,3,
1114,U1028,132733,1,1,1,3,
1115,U1028,135104,0,1,0,1,
1116,U1050,132732,0,1,1,2,
1117,U1050,132609,0,0,0,0,
1118,U1050,132608,0,0,0,0,
1119,U1050,132560,0,2,0,2,
1120,U1050,132740,0,2,0,2,
1121,U1050,132594,0,2,0,2,
1122,U1050,132584,0,0,0,0,
1123,U1028,132740,1,1,1,3,
1124,U1129,132706,0,0,1,1,
1125,U1129,132654,0,0,0,0,
1126,U1028,132630,2,2,2,6,
1127,U1028,132663,0,0,0,0,
1128,U1028,132613,2,2,2,6,
1129,U1087,132667,2,2,1,5,
1130,U1087,135104,1,2,1,4,
1131,U1087,132660,1,1,0,2,
1132,U1087,132732,2,2,1,5,
1133,U1087,132740,1,2,1,4,
1134,U1087,132560,1,2,1,4,
1135,U1087,132594,1,2,1,4,
1136,U1087,132663,1,2,1,4,
1137,U1065,132626,1,0,1,2,
1138,U1065,132706,2,1,2,5,
1139,U1129,132561,1,2,2,5,
1140,U1065,132665,1,1,1,3,
1141,U1129,132665,0,0,0,0,
1142,U1065,132561,1,1,1,3,
1143,U1039,132626,2,2,1,5,
1144,U1039,132564,1,1,2,4,
1145,U1065,132654,1,1,1,3,
1146,U1039,132665,1,1,2,4,
1147,U1130,132654,0,0,0,0,
1148,U1130,132561,0,0,0,0,
1149,U1130,132626,0,0,0,0,
1150,U1130,132706,1,2,1,4,
1151,U1043,132608,1,1,1,3,
1152,U1043,132609,1,2,1,4,
1153,U1011,132717,2,2,1,5,
1154,U1043,132613,1,1,1,3,
1155,U1011,132564,1,1,1,3,
1156,U1043,132732,1,1,1,3,
1157,U1043,132630,1,1,1,3,
1158,U1011,132715,1,1,0,2,
1159,U1068,132733,1,1,0,2,
1160,U1068,132594,1,1,1,3,
1161,U1068,132660,0,0,0,0,
